NO   texture/no_texture
SO     texture/so_texture
WE       texture/we_texture
EA        texture/ea_texture

F           220,100,0
C          225,30,0

111111
101001
100001
100001
100001
10001
111111
