NO   texture/no_texture
SO     texture/so_texture
WE       texture/we_texture
EA        texture/ea_texture

F           220,100,0
C          225,30,0

11111
10001
10N01
10001
11111
