NO   texture/no_texture
SO     texture/so_texture
WE       texture/we_texture
EA        texture/ea_texture

F           220,100,0
C          225,30,0

11 111
101001
10N001
100001
111101
