NO   texture/decor_8x8.xpm
SO     texture/greystone.xpm
WE        texture/mossy.xpm
EA         texture/wood.xpm

F           128,128,128
C           0,127,255

111111
101001
100011
10N001
100101
100101
111111
