NO   texture/dog1.xpm
SO     texture/dog2.xpm
WE        texture/dog3.xpm
EA         texture/dog4.xpm

F           128,128,128
C           0,127,255

111111
100001
101001
11N101
101001
100001
111111
